龙泉生活	Leven Op de Tempel
龙泉寺	Longquan Tempel
僧俗二众	Sangha en volgelingen
法会	Dharma Bijeenkomst
祈福法会	Dharma Bijeenkomst voor Zegen
吉祥普佛	Gebed voor Goedgunstigheid
蒙山	Dharma Bediening voor Geesten en Gestorven Zielen
皈依	Toevlucht tot de Drie Juwelen
新年寄语	Zinspreuk voor het Nieuwe Jaar
龙泉图书馆	Longquan Bibliotheek	Longquan Library
释迦牟尼佛	Boeddha Shakyamoeni 	Shakyamuni Buddha 
释迦牟尼佛成道日	de dag waarop Boeddha Shakyamoeni de staat van verlichting bereikte	the day Shakyamuni Buddha attained his Enlightenment
腊八粥	Laba pap	Laba Porridge
《大般若经》	Mahaprajnaparamita Soetra	Mahaprajnaparamita Sutra
品	hoofdstuk	chapter
会议学习	Vergadering en Reflectie
法师	meester;eerbiedwaardige	Master; venerables
龙泉动漫中心	het animatiecentrum van de Longquan Tempel
学诚大和尚	 de eerbiedwaardige meester Xue Cheng	Ven. Master Xuecheng
护持	koesteren	enshrine, shield and sustain
仁爱慈善	Ren Ai Liefdadig Fonds	Ren Ai Charity Foundation
龙泉学修	Studie en Oefening op de Tempel
开示	Dharma toespraak	Dharma talk; instruction
教化部	het onderwijscentrum	Teaching Department
北京市仁爱慈善基金会	Het Beijing Ren Ai Liefdadigheidsfonds	Beijing Ren Ai Charity Foundation
