佛	Buddha
垄	ridge
孝	filial piety
柴	Firewood
798国际艺术区	798 International Art Zone
AAAA级旅游景区	4A-Level Tourist Attraction
QQ群	QQ Group
一周年纪念日	anniversary
一脉相承	share the same origin
万佛忏	Ten Thousand Buddha's Repentance
万佛圣城	the City of  Ten Thousand Buddhas
万缘茶棚	Wan Yuan tea shed
三宝	the Three Jewels
三十二篆金刚经	Diamond Sutra in 31 Seal Characters with sutra
三十五佛忏	The thirty-five Buddhas of confession
三坛大戒	Triple-platform Ordination
三步一拜	three-step-one-bow pilgrimage
三藏十二部佛典	the Tripitaka and the twelve Divisions
三藏大法师	Tripitaka Mahapandit
上殿	attend the morning and evening recitations
上路	started on the right track
上品戒	great percept
上大供	making great offerings
上座部	Theravada
上方寺	Shangfang Temple
上晚殿	attend the evening recitation
上求佛道	seeking the Buddha's path above
下化众生	Transforming Sentient Beings
不可思议	remarkable;incredible
不断进取	keep forging ahead
不治之症	incurable illness
不辞劳苦	work hard
与人为善	being kind to others
与时俱进	keep pace with times
专注	concentration on;focus on
专栏作家	columnist
专题报道	special report
专题访谈	special interview; exclusive interview
世俗	secular
世尊	Shakyamuni Buddha
世间	mundane
世出世间	mundane and supramundane
世界与传统宗教领袖大会	World and Traditional Religious Leader Conference
世界佛教徒联谊会	World Fellowship of Buddhists (WFB)
世界佛教论坛	World Buddhist Forum
世界和平祈愿法会	world peace prayer Dharma assembly
世界宗教和平会议	World Assembly of Religions for Peace
世界宗教和平祈祷法会	The World Religious Praying Dharma Assembly for World Peace
世界宗教研究所	Institute of World Religions
世界宗教者和平祈祷集会	Interreligious Gathering of Prayer for World Peace
世界无烟日	World No-Tobacco Day
世间法	mundane dharma
业缘	karmic connections
丛林	The Monastery
丛林学院化，学院丛林化	the academic monastery, the monastic academy
东张西望	look around
东方文化	Asian culture
东西方文明	Eastern and Western human civilizations
东配楼	East Wing Building;East Side Building
两会	the China NPC & CPPCC Sessions
两岸	from both sides of the Straits
两序大众	the Sangha and laypeople
严持戒律	strictly observe precepts
中医	Traditional Chinese Medicine
中线	middle line
中视	Taiwan CTV
中佛罗里达州大学	University of Central Florida
中共中央政治局常委	the Standing Committee of the Central Political Bureau of the CPC
中共北京市委统战部	the United Front Work Department of CPC BeijingMunicipal Committee
中华传统节日	Chinese traditional festival
中华儿女	China People
中华全国青年联合会	All-China Youth Federation (ACYF)
中华大藏经	Chinese Tripitaka
中华宗教文化交流协会	China Religious Culture Communication Association
中华少年儿童慈善救助基金会	China Charities Aid Foundation for Children
中华文化	Chinese culture
中华文明	Chinese civilization
中华民族	Chinese
中华民间灾害联合救助行动	Chinese Non-governmental Joint Action of Calamity Salvation
中华社会救助基金会	China Social Assistance Foundation
中华维鬘学会	Amala Association of China
中南海	Zhongnanhai
中台禅寺	Chung Tai Chan Monastery
中国人民公安大学	Chinese People’s Public Security University
中国人民大学	Renmin University of China
中国人民大学佛教与宗教学理论研究所	the Institute for the Study of Buddhism and Religious Theory of Renmin University of China
中国人民大学国学院汉藏佛学研究中心	The Research Center for the Sino-Tibetan Buddhism Study, School of Chinese Classics, Renmin University of China (RUC),
中国人民大学国际佛学中心	International Centre for Buddhist Studies of Renmin University of China
中国人民大学国际关系学院	International Studies School of Renmin University of China (RUC)
中国人民大学培训学院	Training College of Renmin University of China
中国人民大学汉青经济与金融高级研究院	the Hanqing Advanced Instituteof Economics and Finance of Renmin University ofChina
中国人民大学法学院法律与宗教研究中心	the Law & Religion Research Center of Law School, Renmin University of China
中国人民大学法律与宗教研究中心	the Research Center for Law and Religion of RUC
中国传媒大学	the Communication University of China
中国传统文化	Chinese traditional culture
中国佛学院	Buddhist Academy of China
中国佛教代表团	Chinese Buddhist delegation
中国佛教协会	Buddhist Association of China
中国佛教协会副会长	the Vice President of the Buddhist Association of China
中国佛教协会咨议委员会	the Consulting Committee of Buddhist Association of China
中国佛教协会直属寺院执事培训班	Training Class for Executives of Monasteries Directly under the Buddhist Association of China
中国光彩事业促进会	China Glory Society
中国光彩社区服务产业集团	the China Glory Community Service Group
中国公益节	China Charity Festival
中国共产党第十八次全国代表大会	the 18th People's Congress
中国农业大学	China Agriculture University
中国冶金报	China Metallurgical News
中国反邪教协会	China Anti-Cult Association
中国发展出版社	China Development Press
中国国际乐活暨有机活力农耕论坛	China International LOHAS & Organic and Biodynamic Agriculture Forum
中国国际友好联络会	China Association for International Friendly Contact (CAIFC)
中国图书馆年会	Annual Conference of China’s Libraries
中国地质大学	China University of Geosciences
中国宗教学会	Religious Society of China
中国宗教杂志社	China Religion Magazine Office
中国宗教界和平委员会	China Committee on Religion and Peace
中国广播网	The Chinese Radio Network
中国政法大学	China University of Political Science and Law
中国政法大学逸夫会议中心	Yifu Conference Center of China University of Political Science and Law
中国教师发展基金会	Chinese Foundation for Teacher Development
中国教育学会	Chinese Society of Education
中国新闻网	Chinanews
中国新闻周刊网	China Newsweek
中国日报	China Daily
中国检察官协会	the Prosecutor Associationnof China
中国汉传佛教历代经籍目录通检	the classic sutra catalogues index of Chinese Buddhism
中国灵山公益慈善促进会	The inauguration of China Lingshan Philanthropy Promotion Association
中国电子文件管理论坛	China Electronic Records Management Forum
中国矿业大学	China University of Mining and Technology
中国社会科学报	Chinese Social Sciences
中国社会科学院世界宗教研究所	Institute of World Religions of the Chinese Academy of Social Sciences
中国社会科学院梵文研究中心	Chinese Academy of Social Sciences, Sanskrit Research Center
中国科学技术协会	China Associations for Science and Technology
中国科学院心理研究所	The Psychology Institute, Chinese Academy of Sciences (CAS)
中国科技馆	China Science and Technology Museum
中国科技会堂	China Hall of Science and Technology
中国移动开发者大会	China Mobile Developer Conference
中国税务学会	Chinese Tax Institute
中国网络科学论坛	China Network Science Forum
中国翻译协会	China Translators Association (CTA)
中国艺术研究院宗教艺术中心	Religious Art Center of Chinese National Arts Academy
中国艺术研究院非物质文化遗产研究保护中心	China Intangible Cultural Heritage Protection Center of Chinese National Arts Academy
中国藏语系高级佛学院	High-level Tibetan Buddhism College of China
中国财富出版社	China Fortune Press
中国贸易报	China Trade News
中国道教协会	Chinese Taoist Association
中国邮政	China Post
中国青年报	China Youth Daily
中国非公募基金会	China Private Foundation Forum (CPFF)
中央党校中央国家机关分校	Central Government Organs Branch School of Central Party School
中央党校中直机关分校/中央党校中直分校	Central Government Organs Branch School of Central PartySchool
中央民族大学	Central University of Nationalities
中央民族大学哲学及宗教学院	Philosophy and Religion College of Central University for Nationalities
中央电视台	CCTV
中央社会主义学院	Central Institute of Socialism
中央统战部	the United Front Work Department of CPC Central Committee
中央美院	Central Academy of Fine Arts (CAFA)
中央财经大学	Central University of Finance and Economics
中宣部	Publicity Department of the CPC Central Committee
中新社	China News Agency
中欧国际工商学院	China Europe International Business School
中秋节	Mid-Autumn Festival
中秋佳节	Mid-Autumn Festival
中秋晚会	Mid-Autumn Evening Party
中秋联欢会	Mid-Autumn Party
中英文对照	Chinese-English version
中韩日佛教友好交流会议	China-South Korea-Japan Buddhist Friendly Interaction Conference
为众服劳	serve the mass
为法忘躯	aspiring to attain Buddhahood and sacrificing the body for the Dharma
主席	Chairman
主法	preside over the assembly
主旨演讲	keynote speech
主流社会	Mainstream Society
主管法师	the venerable in charge
主讲人	lecturer
主题发言	keynote speech
主题沙龙	themed salon
主题研讨	symposium
义理	doctrines
义工服	volunteers' uniforms
九九重阳敬老暖心法会	Double Ninth Festival Warm Heart Dharma Assembly
习劳	love of labor
习气	habits
书函	letter papers
书法	Calligraphy
书记	Monastic Secretary
书院	Academy
书记法师	Monastic Secretary Venerables
乾隆大藏经	Chien-Lung Tripitaka
事业单位	public institution
云水堂	Yunshui Hall
云门山大觉禅寺	Dajue Chan Monastery in Yunmen Mountain
五明	Five Topics of Knowledge
五四青年节	Youth Day
五堂功课	five collective practice sessions
五观堂	Five-Contemplation Dining Hall
亲近	rely on
亲友会	Family and Friends' Meeting
人事物	people, events, things
人大常委会	the Standing Committee of NPC (National People's Congress)
人文主义	humanism
人文地理	human geography
人文学家	humanities scholar
人文环境	humanistic environment
人文科学院	the School of Humanities and Social Sciences
人民网	People.com.cn
人民大会堂	the Great Hall of the People
人民日报海外版	the People's Daily Overseas Edition
人物专栏	People column
人间净土	a piece of pure land on earth
仁爱网	www.chrenai.com
仁爱之歌	The Song of Ren Ai
仁爱助学	Ren Ai Educational Assistance
仁爱孝德奖	Ren Ai Award of Filial Piety and Virtue
仁爱孝德之星	Ren Ai Filial Piety and Virtue Star
仁爱心栈	Ren Ai Charity Stand
仁爱救援队	Ren Ai Rescue Team
仁爱灾害救助中心	Ren Ai Calamity Salvation Centre
仁爱社区服务中心	Ren Ai Community Service Center
仁爱祈愿林	Ren Ai Blessing Forest
仁爱衣+衣	Ren Ai Clothing Donation Project
代人着想	think of others
代僧王	the President of the Executive Committee For the Acting of the Supreme Patriarch
以见导行	guide action by right view
仪轨	ritual
价值观	views on value
任重道远	The burden is heavy and the road is long
伊斯兰教	Islam
众生	all living beings
会长	president; chairman;
传人	successor
传戒	Transmit Precepts
传承	inherit; persevere and pass on;inheritance
传授	transmit
传灯	pass on the lamp
传统文化	traditional culture
传统美德	traditional virtue;traditional merits
伽蓝	Sangharama
伽蓝菩萨	Sangharama Bodhisattva
住世	stay in the world forever;continuing existence ;long life
住持	Abbot
住持正法	Maintaining Proper Dharma
体悟	understand
佛世	Buddha's era
佛事	Buddhist service/rituals
佛像	Buddhist statues;Figures of the Buddha;image of Buddha;
佛典	Buddhist scriptures
佛制	traditional Buddhist practice；Regulations /practice prescribed by the Buddha
佛力	Buddha's wisdom and effect
佛号	Buddha names
佛堂	Buddhist Prayer Hall/Room
佛子	Buddhists
佛学	Buddhism ;Buddhist
佛教	Buddhism
佛法	Dharma; Buddha Dharma; Buddhism
佛珠	Buddhist prayer beads
佛经	Buddhist Sutras
佛门	Bhddhism
佛陀	Buddha;Sakyamuni Buddha
佛光山	Fo Kwang Mountain;Fo Guang Shan
佛弟子	disciples of the Buddha
佛所行赞	Gatha of The Acts of the Buddha
佛指舍利	Sakyamuni’s Finger Sarira
佛教徒	Buddhists
佛教界	Buddhist community/circles
佛教事业	Bhddhism; Buddhism enterprise; Dharma activities
佛教友好交流会议	Buddhist Friendly Interaction Conference
佛教复兴会	Buddhist Revival Association
佛教大学	Buddhist university
佛日增辉	glorifying Buddha;The Buddha light illuminating
佛涅槃日	Bhddha's Nibbana/Nirvana Day
佛牙舍利	Buddha’s/Sakyamuni's Tooth Sarira
佛罗里达州	Florida
佛菩萨	Buddhas and Bodhisattvas;Buddhist idol
佛菩萨圣诞	birthdays of Buddhas and Bodhisattvas
佛诞日	Buddha's birthday
佛说仁王护国般若经	Prajna Sutra of the Humane King Who Protects His Country
佛说佛名经	Buddha's Name Preached by Buddha Sutra
佛说盂兰盆经	The Ullambana Sutra preached by Buddha
佛顶骨舍利	Buddha's Parietal-bone Relic
作息	work and rest
作持	practice
作法	karma ceremony
供众	the offering public
供佛	offering to Buddha
供养	make offerings
供奉	Enshrining activity; consecrate;enshrine and worship
供斋	offer a meal; offer a vegetarian diet
供灯	offering  lamp
供养组	the Offering Group
依师	relying on the excellent teachers
依止	rely on/upon
依律安僧	in accordance with precepts to ensure the continuance of the Sangha
依教奉行	practice the Buddha’s teachings
俄罗斯传统佛教协会	Traditional Buddhist Sanghas of Russia
信仰	faith
信众	disciples
信心	confidence
信念	belief
信息化	informatization
信息技术组	IT Group
信教群众	disciples
修学	practicing and studying
修心	mind-training
修持	study and practice
修行	practice
修道	practice
修因契果	practicing cause and effect
修学实践	study and practice
修学环境	environment for study and practice
修行本起经	the Sutra on the Origination of Cultivation
修行生活	life of practice
修身养性	self-cultivation
倡导者	advocate
值佛闻法	encounter the Buddha, hearing the Dharma
偈颂	gatha
偈颂体	gatha form
僧众	Monk
僧伽	Sangha
僧团	The Sangha
僧寮	Sangha's domitory
僧尼	monks and nuns
僧才	monk
僧服	clothing for monks
僧格	character as a monk
僧衣	Monk's clothing
僧俗二众	The Sangha and laypeople
僧团执事会议	The Sangha Excecutive Board Meeting
僧团教务会议	Sangha Educational Administration conference
儒学	Confucian Studies
儒家	Confucianism
元宵	sweet dumplings
元旦	New Year's Day
元宵节	Lantern Festival
元宵灯会	lantern show
元宵网络灯会	internet lantern show on Lantern festival
元宵节团圆祈福法会	Dharma Assembly for Lantern Festival Reunion and Blessing
元旦祈福法会	A New Year Dharma Assembly for Blessing
先贤	sages
先人前贤	sages , ancestors
党政干部理论学习班	Theory Study Class for Party and Government Cadres
党组书记	Secretary of the Party Committee
兜率内院	Adytum of Tusita Heaven
入世	engagement of Buddhism in the secular world
入手处	point to start
全印度比丘僧伽会	the Sangha Council of the All India Bhiksu Maha Sangha
全国人大会议中心	the National People’s Congress Conference Center
全国人大常委	the Standing Committee of NPC (National People's Congress)
全国政协	the National Committee of Chinese People’s Political Consultative Conference (CPPCC)
全国政协会议	the CPPCC (Chinese People's Political Consultative Conference)
全国政协委员	member of the CPPCC National Committee
全国政协常委	Standing Committee of CPPCC
全国政协民宗委	the Committee for Ethnic and Religious Affairs under the CPPCC National Committee
全国生命教育工作委员会	National Life Education Working Committee
全国青联宗教界别组	the Ethnic & Religious Affairs Department of All-China Youth Federation
全球一体化	globalization
八关斋戒	Eight Precepts
八语种微博	"microblog of eight languages;
eight-lingual microblogs"
八达岭古长城	the ancient Badaling section of the Great Wall
公众	the public;  general public
公益	public welfare
公共秩序	public order
公募基金会	public-raising foundation
公益深交会（中国·深圳公益项目交流展示会缩写）	the Fair of Non-profit Organizations in Shenzhen
公示栏	the bulletin board
六根	the Six Sense-organs
六和敬	the Six Points of Reverent Harmony
六斋日	on the six days of fast of each month
六祖坛经	Altar Sutra; The Sutra of Hui Neng
共业	collective karma
共修	Dharma Practice activities
关照	take care of
其乐无穷	endless enjoy
典座	Monastic Chef
典籍	classics
养生	Health Preservation
养生粥	healthy porridge
内明	spirituality (adhyātmavidyā )
内院	inner courtyard
内阁部长	Cabinet minister
写生	make sketches
农历	lunar
农场	farmland
农禅	Farming and Chan
农耕	farming
农业与农村委员会（“全国人大农业与农村委员会”简称）	the Agriculture and Rural Affairs Committee
农民工子女	the children of rural workers
农禅体验	Agriculture and Chan Experience
农禅并重	Valuing Farming and Chan
冬至	winter solstice
决断	decisiveness;Precepts
净人	postulants
净化	purify;clean
净信心	reverence; complete faith
净土五经	the Five Pureland Sutras
准净人	postulant candidate
准讲师	instructor candidates
凤凰岭	Phoenix Ridge
凤凰网	ifeng.com
凤凰卫视	Phoenix TV
出世	supramundane;Withdraw from the Mundane World
出坡	do monastic work;laboring;work
出家	become a monk/nun;Renunciation;take renouncement
出家人	Buddhist monks and nuns;monk or nun;monk;nun
出家众	monks
出家行者	postulants
出版署（中华人民共和国新闻出版总署简称）	National Press and Publication Administration
出离心	Aspiration to Renounce the Secular World
创始人	founder
利他	benefit others
利生	benefit living beings
利乐有情	benefit sentient beings
别开生面	Spectacular;Creative;interesting
别有趣味	Interesting
制戒	precept-setting
剃度	tonsure
前行	Preparation
前世今生	Past and Present
副秘书长	vice executive secretary; Deputy Secretary-General
割爱辞亲	give up ones love and  leave family to...；bid farewell to their families to deliver all the sentient beings
劝勉	exhort
劝发菩提心	encourage to generate Bodhicitta
功德	merits and virtues
功课	practice sessions;lessons
功德衣	Kathina Robes
加被	bless
加利福尼亚整合研究学院	California Institute of Integral Studies
加州大学	University of California
加拿大广播公司	CBC Radio Canada
动土洒净仪式	ground planting and purification ceremony
动漫博览会	Comic & Animation Exhibition and Convention
助缘	be conducive to
助学项目组	Educational Assistance Project Team
助念往生	chant the sutras for rebirth in the Pure Land
助残扶弱	Help the Disabled and the Weak
助理秘书长	assistant secretary-general
勇猛	courage
勉励	encourage
勿忘初心	Don’t Forget the Original Aspiration
包罗万象	all-embracing
化身	phantom;embodiment
北京会议中心	Beijing Conference Center
北京佛教居士林	the Lay Buddhist Association of Beijing
北京复兴大国学文化基金会	the Beijing Great Sinology Foundation
北京外国语大学	Beijing Foreign Studies University
北京大学	Peking University
北京大学光华管理学院	Guanghua School of Management at Peking University
北京大学宗教文化研究院	Research Institute of Religion and Culture at Peking University (PKU)
北京大学百年讲堂	Centennial Auditorium, PKU
北京大学翻译协会	Translators Association of Peking University
北京大学英杰交流中心	Yingjie Exchange Center of Peking University
北京天主教爱国会	Beijing Catholic Patriotic Association
北京工人体育馆	Beijing Workers' Stadium
北京市人民政府研究室	Research Office of the People’s Government of Beijing Municipality
北京市仁爱慈善基金会	Beijing Ren Ai Charity Foundation
北京市创建和谐寺观教堂活动	Creating Harmonious Monasteries, Taoist Temples and Churches in Beijing
北京市委宣传部	the Publicity Department of the Beijing Municipal Committee
北京市宗教事务局/北京市宗教局	Beijing Municipal Bureau of Religious Affairs (参考北京机构名称)
北京市慈善义工协会	Beijing Charity Volunteer Association
北京市民政局	Beijing Municipal Bureau of Civil Affairs
北京市海淀区侨友联谊会	Overseas Chinese Association of Beijing’s Haidian District
北京市海淀社会组织联合会	Haidian Association of Social Organization
北京师范大学人文宗教高等研究院	Beijing Normal University’s Institute for Advanced Study of the Humanities and Religion
北京师范大学敬文讲堂	Jingwen Lecture Hall of Beijing Normal University
北京应物会议中心	Beijing Yingwu Conference Center
北京建设工程学院	Beijing University of Civil Engineering and Architecture
北京电视台	BTV
北京科学技术协会	Beijing Associations for Science and Technology
北京精神	Beijing Spirit
北京航空航天大学	Beijing University of Aeronautics and Astronautics
北京西客站南广场	the South Square of Beijing West Railway Station
北京西山灵光寺	the Lingguang Monastery of Beijing’s Western Mountains
北京龙泉寺	Beijing Longquan Monastery
北大佛学教育研究中心	the Research Center for Buddhist Education of Peking University
北大耕读社	the PKU Farming-Reading club
北配楼	the northern side building
医方明	medicine (cikitsāvidyā)
千手千眼	A Thousand Arms, A Thousand Eyes
千江水月	A Thousand Moons in a Thousand Lakes
升座	enthronement
升座典礼	enthronement ceremony
午斋	lunch
华北电力大学	North China Electric Power University(NCEPU)
华德福教育	Waldorf Education
华文出版社	Sino-Culture Press
单资	allowance
南京栖霞山文化节	Cultural Festival of Qixia Mountain, Nanjing.
南传上座部佛教	the Theravada Buddhism
南少林寺	Nan Shaolin Temple
南山律三大部	the three great Vinayapitakas of the Nanshan School
南线工棚	the southern work shed
博大精深	extensive and profound
博鳌亚洲论坛	Bo'ao Forum for Asia
卫赛节	the United Nations Day of Vesak
印度文化关系委员会	India Council for Cultural Relations
历程	in the course of
历练	practice
历事练心	undertake tasks and cultivate minds
历史沿革	history
参学	learning experiences
参悟	think about
参赞	Counselor
友成企业家扶贫基金会	You Change China Social Entrepreneur Foundation
发心	aspiration;vow;aspire;be self-motivated
发愿	making vows;vow
发改委	Development and Reform Commission
发起人	initiator
受戒	receive the precepts of the Buddha's teachings
受持	transmit
受筹	Taking Salaka (taking sticks to make vows to participate in the Summer Retreat).
受益匪浅	benefited greatly
古刹	ancient temple
古德	Patriarchs
古朴	pristine
古柏	old cypresses
古籍	ancient works/books
古生物学家	paleontologist
叩击	srike
召集人	conveners
可用之材	usable materials; avalable talent
可降解塑料薄膜	biodegradable plastic membrane; degradable plastic membrane
台湾佛光山宗委会	Fo Guang Shan Religious Affairs Committee
台湾净律寺	Jinglv Monastery in Taiwan
台湾政治大学社会科学学院公民社会暨地方治理研究中心	the Civilian Society and LocalControl Research Center of the College of Social Sciencesat Chengchi University in Taiwan
史料	historical materials
司长	Director
吉祥	Auspicious;lucky; propitious
吉祥经	Mangala Sutta
吉祥普佛	Prayer for Auspiciousness
同仁	Colleagues
同修	Dharma companions
同胞	Compatriots
同声互译	simultaneous interpretation
同声传译	simultaneous interpretation
同愿同行	Common Aspirations and Actions
同文同宗	have the same ancestors and clan
同根同源	share the same origin
同源同祖	have the same bloodline and ancestors
同行善友	Dharma companions
名誉会长	Honorary President
名誉院长	Honorary President
吟诵	chanting
周利盘陀伽尊者	Ven. Culapanthaka
周年回顾会	Anniversary Review Meeting
周年庆典	anniversary  ceremony
周年庆祝会	anniversary celebration
周年纪念	anniversary
周末义工	weekend volunteers
周末共修	Weekend Group Study
命脉	lifeblood
和合	harmony
和君商学院	Hejun Business School
和尚•博客	Monk • Blog
和尚•微博——北京龙泉寺的365天	Master Xuecheng's Microblog-Beijing Longquan Monastery 365 Days
和平祈愿文	peace aspiration prayer;  peace prayer
和平祈福法会	Praying for Bliss and Peace to both sides of the Taiwan Straits
和而不同	Harmony with Diversity
和谐世界	Harmonious World
和谐社会	harmonious society
品茶	taste tea
哈佛大学	Harvard University
哥伦比亚大学	Columbia University
唱诵	chant
唱念仪轨	chanting rituals
善业	good Karma
善信	disciples
善巧	skillfully
善心	virtuous mind
善本	precious collection of rare books
善根	virtuous roots
善法	virtuous dharma
善行	virtuous deeds
善巧方便	flexibility and skillful means
善用其心	cultivate one's heart
善知识	excellent teachers
善行组	Good Deed Team
善行天下	Good Deeds around the World
喜闻乐见	be popular with, cater to, be enjoyed and shared
四分律	Four Sections of the Vinaya
四分律删繁补阙行事钞/四分律行事钞/行事钞	Recording the Particular Practices of the Commentary of the Vinaya of the Four Sections
四分律含注戒本疏	the Book of Bhiksus Precepts in Dharmagupta Vinaya
四分律比丘含注戒本疏行宗记	the Commentary on the Book of Bhiksus Precepts in Dharmagupta Vinaya
四分律行事钞资持记/资持记	Record on the Particular Practices
四和仁爱	Si He-Ren Ai
四圣供	Four Saints Offering
四大部组	the Charity, Cultural and Publicity departments and the Great Chinese Culture Revival Foundation
四川大学	Sichuan University
四海书院	Beijing Sihai Confucius School
四海尼山孔孟夏令营	SihaiNishan Confucian and Mencian Summer Camp
回向	Dedicating Merits
回填土	backflling soil
因明	logic (hetuvidyā)
因果	causes and effects
因缘	causes and conditions;conditions; reasons
因材施教	Individualized Instruction
团圆饭	reunion lunch
团拜会	Greeting Party
国学	Sinology
国务院	State Council
国务院发展研究中心欧亚社会发展研究所	Euro-Asian Social Development Research Institute of theDevelopment Research Center of the State Council
国土资源局	Bureau of Land and Resources
国学社	Traditional Sinology Association
国家会议中心	CNCC/China National Convention Center
国家博物馆	National Museum of China
国家图书馆	National Library of China
国家宗教事务局/国家宗教局	State Administration of Religious Affairs;State Bureau of Religious Affairs
国家宗教事务局研究中心	Research Center of the State Administration of Religious Affairs
国家税务总局	the State Administration of Taxation
国庆黄金周佛教文化系列活动	a series of activities on Buddhist Culture during the  National Day Golden Week
国泰民安	prosperous country, peaceful life
国防大学	National Defense University
国际司	the Department of International Organizations and Conferences
国际在线	International Online
图书音像制品	books and audio-visual materials
图文并茂	with both photographs and text
圆满	successful;fully;perfect; complete
圆寂日	parinirvana day
圆通学舍	Yuantong Practice School
土灶	mud stove
圣像	holy statues
圣地	the Holy Land
在家居士	laypeople
地藏殿	Ksitigarbha Hall
地藏经	Sutra of Bodhisattva Ksitigarbha’s Fundamental Vows
地藏十轮经	Ten Cakras of Ksitigarbha
地藏菩萨	Ksitigarbha Bodhisattva
坐禅	the meditation
坚持不懈	persist in ;soldier on;keep on one resolve
垃圾精细分类	disposal of all kinds of rubbish
埃克塞特大学	University of Exeter
城市管理协会	City Management Association
培植福报/培福	accumulate merits
培福养慧	cultivate  merits and nurture  wisdom
基督教	Christian
基督教爱德敬老院	Christian Ai De Nursing Home
基督教科学箴言报	Christian Science Monitor
基调发言	keynote speech
堂口	function room
境外	overseas
境界	realm; boundary
境由心生	The world is as how you fell; the envirnonment is a reflection of our mind
增上	progress
增进业缘	enhance the karmic connections
复兴	Renaissance;rejuvenation; to revive
复旦大学	Fudan University
复旦大学哲学系宗教研究室	Philosophy Department’s Research Office of Religious Studies at Fudan University
复旦大学宗教研究所	Research Institute of Religious Studies at Fudan University
外相	external appearance
外事司	Foreign Affairs Department
外交部	Ministry of Foreign Affairs
外地学佛小组	non-Beijing Buddhist study groups
外文讲师	multilingual instructors
外斋堂	outer dining hall
多元主义	pluralism
多元文化	Multicultures;diverse cultures;multiculturalism
多宗教交流	multi-religion communication
多语种交流会	Multi-lingual Volunteers Exchange Meeting
多语种小剧场	multilingual theater
多语种微博	multilingual microblogs
大乘	Mahayana
大众	laypeople; the public; disciples
大供	grand food offering
大孝	the highest form of filial piety
大寮	kitchen
大德	virtuous laypeople;eminent monks
大悲	great compassion
大愿	Great aspiration;Great vows
大智	great wisdom
大殿	main hall
大界	borderline
大行	great practice
大乘佛法	Mahayanist sutras; Mahayana sutras
大乘百法明门论	Mahayana Treaties on the Illumination Door of the One Hundred Dharmas;Mahāyāna-śatadharma-prakāśamukha-śāstra
大和尚	Ven. Master
大地心有机农场	Earth-Heart Organic Farm
大悲咒	Great Compassion Mantra;Mahakaruna Dharani Sutra
大悲禅院	Temple of Great Compassion
大慈恩寺	Great Ci’en Monastery
大方广佛华严经/华严经	Avatamsaka Sutra
大智度论	Great Treatise on the Perfection of Wisdom
大有可为	play an important role in society; Great Prospects
大般涅槃经	Mahaparinirvana Sutra
大般若经	Mahaprajnaparamita Sutra
大般若经•东北方品	Mahaprajnaparamita Sutra - the chapter of North East
大藏经	Tripitaka
大长老	Ven.
大雄宝殿	Main Hall
天井	patio
天主教	Catholic
天之骄子	Best Talents
天台宗	Tiantai Buddhism
天王殿	Tian Wang Hall
头陀行	the Dhuta practice Bhiksus
奉送	offer... for free；distribute ；provide；serve
奉粥点	porridge service station
契机	at the right time
契理契机	based on their specific need
女众	female
如来家业	Buddha’s responsibility
如法如律	in accordance with the Dharma and the Vinaya
妇联	The Women's Federation
妙法精舍	Dharma Vihara
委员长	chairman
姜汤	ginger soup
姜糖水	sweet ginger soup
威仪	conduct , dignity
娑婆	the hymn of Saha Realm
孔子	Confucius
孔孟之道	the way of Confucius and Mencius; Confucius and Mencius
字纸	papers with characters
孝悌	Filial Piety
孝道	filial duty
孝顺	being filial towards ones parents
孝亲报恩	express filial piety and gratitude to parents and ancestors
孝亲敬老	showing filial piety and respect to parents and the seniors
孤本	the only existing copy
孤儿助学项目	Educational Assistance for Orphans Project
学人	scholars
学佛	Buddhist Study
学修	study and practice
学僧	disciples
学员	students
学子	students
学界	academia
学风	academic atmosphere
学以致用	put what they have learned into practice
学佛小组	Buddhist Study Group
学修处	Student Affairs Division
学修一体	combine Buddhist study with practice
学修体系	the system of study and practice
学修平台	platform for Buddhist study and practice
学修心得	experiences of study and practice
学修环境	environment for study and practice
学修生活	study and practice
学术界	academic circle
学术研讨会	academic seminar
学诚大和尚	Ven. Master Xuecheng
学诚大和尚侧记	Stories of Ven. Master Xuecheng
学诚大和尚博客	Ven. Master Xuecheng’s Blog
宇都宫大学	Utsunomiya University
守志奉道	Practice according to the teachings of the Buddha
安居	Retreat
安奉仪式	ceremony of offerings and enshrinement
安心办道	focus on the causes of Three Jewels
宗教	religion
宗旨	tenet;purpose
宗派	sect
宗务总长	general of Religious Affairs
宗喀巴大师	Ven. Master Tsong-kha-pa
宗喀巴大师应化因缘集	The Collection of Ven. Master Tsong-kha-pa's Karma of Induction Exemplifications
宗教学	religious study
宗教界	religious community
宗教仪式	religious ritual
宗教典籍	religious classics
宗教团体	religious groups
宗教多元主义倡导者	religious pluralism advocate
宗教对话	religious dialogue
宗教政策法规	laws and regulations about religion
宗教活动场所	sites for religious activities
宗风行谊	the words and deeds
官刻大藏经	official block-printed Tripitakas
宝性论	Ratnagotravibhaga
宝性论大疏	Ratnagotravibhaga
宝相庄严	look solemn and dignified
实业家	entrepreneurs
客堂	Reception Office; Monastic Reception
客座教授	visiting professor;guest professor
宾夕法尼亚大学	University of Pennsylvania
宿业	sins
密集用功	intensive practice
寒食	Hanshi Day ；Tomb Sweeping Day；
寓学于乐	intergrate learning in entertainment
寓法于耕	integrate Dharma into plowing
寮房	dormitory
对治	remove;overcome,deal with;against
对外友好协会	Chinese People's Association For Friendship with Foreign Countries
寺院	Monastery
寺院巡礼	tour around the Monastery
导师	advisor;tutor
尊者	Ven.
尊师重道	respecting teachers and teachings
小乘	Hinayana
小年	Preliminary Eve
小微博，大缘起	Micro Blog, Macro Causation
少欲知足	little desire and contentment
尘垢	attachments
尼山世界文明论坛	Nishan World Civilization Forum
尼泊尔蓝毗尼访问年	Lumbini Visit Year
尼泊尔驻华大使馆	the Nepal Embassy in China
局长	Director; director general
居士	laypeople
居士服	clothing for laypeople
居士楼	Laypeople Building
居士团队	laypeople; laypeople teamwork
居士寮房规约	Laypeople Dormitory Regulation
居士挂单规约	Laypeople Registration Regulation
居士斋堂	Laypeople Dining Hall
居士行仪规约	Laypeople Conduct and Behavior Regulation
山上	in the mountain
山下	downtown
山东大学	Shandong University
山东大学儒学高等研究院	Advanced Institute of Confucian Studies, Shandong University
岩洞	cave
川派古琴家	Guqin (an ancient 7-string  instrument) master of Sichuan School
巡寮	patrolling monks' dormitories
巡礼	a tour of the Monastery
工巧明	All technology, tecniques,arithmetic etc
工程部	Construction Department
巴利文	Pāli
巴利三藏	Pāli Sanzo
巴利语系	Pāli Language Department
市长	Mayor
市委书记	party secretary
师父	Venerable Master
师长	teachers
师法友	teachers, teachings and companions
常住	resident
常住义工	resident volunteers
常务理事	the executive director
平安面	noodles
平安小吃	snacks bearing auspicious meaning
平等心	the mind of equality
幸福观	View of Happiness
幸福列车	Happiness Express
广行	vast conduct
广大供养	Grand Offerings
广度有情/广度众生	enlighten all sentient beings
广济寺	Guangji Monastery
广结善缘	create good karma; cultivate affinities
庄严	solemn;dignified
庄严国土	Glorify the Country
库房	storehouse;storeroom;warehouse
应化	incarnation
应量器	the utensil corresponding to the Dharma
底蕴	background;foundation;heritage
度化	relieve and liberate;deliver
建寺安僧	build temple and settle monks;
开光	consecration; consecrate; open  light
开堂	Ordination
开班	The opening ceremony; officially established; class opening;
开示	Dharma talk;instruction
开缘	be allowed to come loose
引文	quotation
弘传	promote;spread; propagate
弘戒	spreading precepts;promote percepts;disseminate percepts
弘扬	promote; develop and expand; advance and enrich
弘法	promote Dharma
弘宣部	Publicity Department
弘法事业	Dharma promoting undertakings
弟子	disciples;students
弟子规	Standards for Students
弥勒菩萨	Maitreya Bodhisattva
弥勒菩萨上生经	Ascent Sutra of Maitreya Bodhisattva
弥勒菩萨圣诞日/弥勒圣诞	the birthday of Maitreya Bodhisattva
当下	every moment we have; the present;present
当值	on duty
彩绘	color-painting
影片导视	movie guidance
往生	rebirth
律仪	precepts and rituals
律典	vinaya
律制	regulations for Precepts
律宗	Vinaya
律师	Vinaya Master
律藏	Vinaya Pitaka
律风	precept style
律典校注	vinaya collating and annotating
得戒和尚	Precept Transmitter
得证圣果	attain enlightenment
德国佛教联盟	German Buddhist Union
德国汉堡大学梵文写本研究所	Sanskrit Manuscript Institute in University of Hamburg in Germany
德尘居	Dechenju Building
心地	mind
心得	experience
心念	minds
心栈	Charity Stand
心灯	Heart Light
心病	spiritual disease
心经	Heart Sutra
心血	painstaking efforts
心开意解	the knots of one's mind were all untied
心文化	Mind Culture class
心灵手巧	ingenious
心路历程	mental journey
忆念	remind
忏悔	repent;repentance;Make Confession
志愿者	volunteer
志求佛道	attain sublime enlightenment
念佛	chant the Buddha’s name
念供	chanting and offering
念诵	chant
念佛团	Group Chanting Amitabha Buddha’s Name
念佛机	the Buddha-name-chanting player
念恩祈福中秋法会	Mid-Autumn Festival Dharma Assembly for remembering kindness and praying for blessings
思维	reflect
思想家	ideologist
总书记	General Secretary
总前行	the final preparation meeting
总务部长	Director of the General Affairs Department
总结行	concluding meeting
总领事	Consul-General
恩师	esteemed teacher;respected teacher
恩德	merits and virtues;kindness;virtuous kindness
恭敬	deferential attitude
恭迎	welcome
恭送	a farewell to
恳亲会	Family Reunion Association
悉达多太子	Prince Siddhartha
悎寤瑜伽	Acting Properly When Going to Sleep
悟道	attain one's enlightenment
悠扬净纯香	Melodious and Pure Incense
悲、智、愿、行	compassion, wisdom, vows and conduct
悲宏誓愿	great compassion and aspiration
悲心愿力	compassion and aspiration
惜福	cherishing blessings
意趣	connotation
意大利华侨华人佛教总会	Overseas Chinese Buddhist Association in Italy
感念	remember with gratitude
感恩	be grateful /thankful
感悟人生	Understanding Life
愿力	aspiration
愿心	aspiration
慈善	charity
慈心	compassion
慈悲	compassion
慈愍	lovingkindness and compassion
慈善部	Charity Department
慈善义工协会	Beijing Charity Volunteer Association
慈善公益事业	philanthropic activities
慈善公益组织联合会	Philanthropy Federation
慈孝文化	Mercy and Filial Piety Culture
慈悲心	heart of compassion
慈悲济世	compassionately save the world
慧心所	Mental Functions of Wisdom
慧炬出版社	Torch of Wisdom Publishing House
成佛	attain Buddhahood
成办	hold
成道	enlightenment;attain enlightment
成圣成贤	Becoming saints and sages
戒会	Dharma Assembly of taking precepts
戒制	precepts; system of precepts
戒子	preceptor
戒学	precepts study
戒律	discipline; precepts
戒期	precept period
戒条	precepts
戒相	form/appearance of precepts
戒本疏	Commentary on the Book of the Prece
手提肩挑	hand and shoulder carried
打坐	meditation
打板	beat the board
打法器	play Buddhist instruments
托钵应供	hold the alms bowls and receive offerings from the public
执事	Executives
执著	attachment
执行董事	Executive Director
扫塔	sweeping pagoda
承事	serve
承担	undertake
承天寺	Chengtian Monastery
承担心	commitment
抄经	Transcribing scriptures;sutra calligraphy
护坡	slope protection
护持	enshrine ;shield and sustain
护法	protector; guardian
护生	care for the live beings
报恩	repay gratitude
报慰	repay
担当	take responsibilities;responsibility
拈香	burn incense
拉拔	mutual help;assistance
拜佛	worship Buddha
拜年	pay New Year’s call
拜忏	bow for repentance
持守	observe precepts
持戒	observe the precepts
挂单	put up at a temple for short a stay
按需分配	allocated according to need
挥毫泼墨	wielded brush and splashed ink with interest
捐衣	clothing donation
授戒	taking Precepts
授衣	Confer Kathina Robes
授课	give lesson
授功德衣	forsaking Robes of Merits
授牌典礼	plaque presentation ceremony
排版	typesetting
排班	line up
接引	welcome;guide
接驾	warmly receive
接待室	reception room
接待组	reception group
提策	remind and encourage
揭牌	unveile the plaque; unveiling
携手同心	join hands with one heart
摄持	be imbued with
摩诃朱拉隆功大学	Maha Chulalongkornrajavidyalaya University (MCU)
撞钟祈福	strike the bell for blessing
放生	Free Captive Animals;liberate captured animals
放香	rest
效学	to learn from
教义	doctrines
教习	educating and learning
教制	the construction of a Buddhist education system; education system
教化	education; teaching
教法	teaching method;  Dharma teachings; Buddhist doctrines
教派	denomination;religion sects
教理	doctrine;Theories and Thoughts
教界	religious communities
教诫	Obeying Disciplines; instruct; precepts
教风	teaching style;religious disciplines
教功德	teaching and virtues;  merits of teaching; contribution of teaching
教务长	academic dean
教化部	Teaching Department
教职人员	teaching staff; Religious Faculty
教证功德	merits and virtues of Dharma teaching and enlightenment
教诫新学比丘行护律仪集解	Exhortation for New Bhiksus to Protect Precepts
敞开心扉	open heart to;open mind to
散乱	distracted
敦煌	Dunhuang
敦煌古本	ancient Dunhuang version
敦煌文化弘扬基金会	Dunhuang Culture Promotion Foundation
敬老孝亲	filial piety
整肃威仪	impressive, dignified, and strict manners
文宣	Publicity
文化学	cultural science
文化部	the Cultural Department
文化体验	cultural experience
文化大观园	Cultural Kaleidoscope
文化强国	Culture-Powerful Nation
文化战略	cultural strategic , cultural strategy
文化自信	cultural confidence
文化自强	cultural self-improvement
文化自觉	cultural consciousness
文化软实力	cultural soft power
文化部外联局	the Bureau of External Cultural Relations of the Ministry of Culture
文明对话	cultural dialogue
文殊供	made offering to Bodhisattva Manjusri
文殊院	Wenshu Academy
文殊师利授记经	The Sutra of the Manjushri's Bestowal of Predictions
文殊菩萨	Bodhisattva Manjusri
文集数据库	Document Database
斋僧	make offering to monks
斋堂	Dining Hall
斋天	Offering Ceremony for Celestial Guardians
断恶修善	turn away from evil and do good
新戒	new precept
新华社	Xinhua News Agency
新年寄语	new year guidance
新戒比丘	newly ordained monks
新春佳节	the Spring Festival
新春华严法会	Avatamsaka Dharma Assembly
新春座谈会	New Spring Symposium
新春祝福	New Years wishes
新春联谊会	Spring Festival Sodality
新民网	xinmin.cn
新泽西大学	University of New Jersey
方丈	Abbot
方便	convenient;Convenience
方便之门	portal;convenient way
施茶	offer free tea
无上	great
无常	impermanence
无我	selfless , selflessness
无明	Ignorance
无边众生	countless livingbeings
无限生命	infinite life
日中临黄友好协会	the Japan-China Rinzai and Obaku Association for Friendship and Exchanges
日持上人显彰会	Japanese Nichiji Shonin Kensyokai
日本临济宗妙心寺派灵云院	Reiunin Temple, Myoshin-ji School of Rinzai sect in Japan
日本佛教会	Japan Buddhist Federation
日本守护大地协会	the Association to Preserve the Earth in Japan
日莲宗	Japanese Nichiren Buddhism
早斋	breakfast
早晚殿/早晚功课	morning and evening recitation
早殿/早课	morning chanting
时代因缘	particular conditions of the era
明相	vision of radiance
明心阁	Mingxin Pavilion
易经	The Book of Changes
星岛日报	Sing Tao Daily
春节	the Spring Festival
春运	the Spring Festival Transportation
春节团拜会	Spring Festival Celebration Gathering
春节拜万佛祈福法会	Dharma Assembly for All Buddha Worshiping and Bliss Praying
春节祈福华严法会	The Blessing and Avatamsaka Dharma Assembly
晚殿/晚课	evening recitation
晨起缘念	daily morning meeting
普佛	praying for auspiciousness
普世价值	universal values
普茶晚会	Evening Tea Party
普贤供	make offerings to Samantabhadra Bhodisattva
普贤菩萨	Samantabhadra Bodhisattva
普贤讲堂	Pu Xian Buddhist Society
智慧	wisdom
智慧显发	wisdom attained
智能终端	Intelligent Terminal
暖棚	green house
曙光	The Dawn
曲阜圣源书院	Nishan Sheng Yuan College in Qufu
曹溪宗	Jogye Order
月饼	mooncake
有序	orderly
有情	sentient beings
有机农业	Organic Agriculture
有机蔬菜	organic vegetables
有条不紊	in an orderly manner
有缘众生	sentient beings
朝圣	pilgrimage
朝山	pilgrimage
朝拜	worship
朝礼	worship
朝外心栈	Chaowai Charity Stand of Beijing Ren Ai Charity Foundation
朝暮课诵	morning and evening chanting
朝阳寺	Chaoyang Monastery
木鱼基金会	Woodenfish Project
本师	the Fundamental Teacher
本有	original
本生	past life
本土化	localization
杂阿含经	Samyuktagama Sutra
来访	come to visit; visit
来之不易	hard-work; hard-earned
树脂地灯	Resin ground lamp
栗子园	chestnut orchard
栗子树	chestnut tree
栗子蘑	chestnut mushrooms
校勘	collation;collate; emendation
校对	proofread; collate
校注	proofreade and annotate ;check and annotate
校释	collation & annotation;collate and annotate
档案室	Archives Room
档案局	Archive Bureau
档案局业务指导科	archives and records management guidance department
梅兰芳大剧院	Mei Lanfang Theatre
梯次	in Echelon
梵呗	Buddhist chanting
梵文	Sanskrit
梵文罗马转写体	Sanskrit in Roman letters
楞严经	Surangama Sutra
楞严祈福法会	Surangama Dharma Assembly for Blessing
槐轩学说	Huai Xuan Theory
次第	stages
欢喜	be joyful;happy;delighted rejoice
欢聚一堂	gathered happily together;gathered joufully
欧洲佛教联盟	European Buddhist Union
止息	go to bed
正信	true belief
正念	right mindfulness
正月	the first lunar month
正知	right view
正见	Right View
正业楼	Zhengye Building
正心神柏香	Positive Mind Cypress Incense
正思维楼	Zhengsiwei Building
正法久住	the everlasting dwelling of Proper Dharma
正法道场	a monastery full of proper Dharma
正知见	correct understanding
正能量	positive energy
正见楼	Zhengjian Building
此岸•彼岸	From This Shore to That Shore
殊胜	special and extraordinary
殊胜难得	special and precious
殷重	solemn
殿堂	hall;palace hall
比丘	Bhiksu;Monks
比丘尼	Buddhist nun
比丘戒	Bhikshu Precepts
比丘班	Bhiksu Class
比丘之路	The Path of Bhiksus;The Road to Becoming a Bhiksu
比丘戒本	Bhiksus Vinaya
比睿山宗教首脑会议	the Religious Summit on Mt. Hiei
毕业典礼	graduation ceremony
毗尼	Vinaya
民众	the public
民间	Non-governmental
民宗局	Municipal Bureau of Ethic and Religious Affairs
民政局	Civil Affairs Bureau
民政部	Ministry of Civil Affairs
民族之脊梁	National Backbone
民族宗教侨务办公室/民宗侨办	the Ethnic,Religious and Overseas Chinese Affairs Office
民盟(“中国民主同盟”简称）	Central Committee of the China Democratic League
水包	water tank
水库	reservoir
水净化蓄水池	water purifing reservoir
水利工程	water conservancy project
永乐北藏	Yongle Northern Tripitaka
汉办	Chinese National Office;NOCFL;Hanban
汉地	Han area; China
汉传佛教	Chinese Buddhism
汉传佛教修学体系	Chinese Buddhism system for study and practice
汉传佛教讲经交流会	Beijing Chinese Buddhism Sutra Lecture Communication Meeting
江西省宗教文化交流协会	Jiangxi Province Religious Culture Communication Association
沙龙	Salon
沙弥戒	Novice Monk Precepts
沙弥班	the Novice Monks Class
沙弥/沙弥师	the novice monks
沙弥戒学班	The novice monk class of precepts study
河仁慈善基金会	He Ren Charity Foundation
河南佛教学院	Henan Buddhism College
法事	Dharma rites
法人	legal personality
法会	Dharma Assembly
法器	Dharma instruments
法堂	Dharma Hall
法宝	Dharma jewel
法师	Venerables
法物	Ritual Utensils
法门	method;means;way
法乳一脉	share the same Dharma origin and heritage
法会处	The Division of Dharma Assembly
法华法会	Lotus （Sutra） Dharma Assembly
法华经/妙法莲华经	Lotus Sutra
法同沙弥	novice monks
法喜充满	be filled with delight in Dharma
法律委员会	Law Committee
法相唯识学派	Consciousness-Only School;Dharma Character School
法缘讲堂	Fayuan Lecture Hall
法身慧命	monks' life of Dharma body and wisdom
法门寺	Famen Monastery
法门之光福慧营	Light of Famen Bliss & Wisdom Camp
法门寺佛学院	Famen Monastery Buddhist College
法雨教化	Dharma enlightenment
法鼓山	Taiwan Dharma Drum Mountain
注释	annotation
泰斗	a leading authority
泼墨挥毫	create calligraphy
洒净	purification ceremony
洒扫	sweeping and cleaning
流通	circulative
流光溢彩	a colorful, shining and brilliant scene
流连忘返	enjoy so much as to forget leaving
流通处	Circulation Department
济济一堂	a gathering of many people
浑然天成	bring out the best in each other; totally natural
浙江大学	Zhejiang University
浴佛	Buddha Bathing
浴佛偈	Hymn of  Buddha Bathing
浴佛节	Buddha Bathing Festival
海外华人	overseas Chinese
海峡两岸	Main land and Taiwan;both sides of the Taiwan Straits
海明寺	Haiming Monastery
海淀区区委组织部	Organization Department of CPC Haidian District Committee
海淀区政协	Haidian District Committee of the CPPCC
海淀区文化委员会	Haidian District Cultural Committee
海淀教堂（北京市基督教海淀堂简称）	Haidian Church
涅槃	Nirvana
消文	explain the text of sutras and scriptures.
涓涓清流	clear/pure streams
深广	deep and wide
深恩	tremendous favor
深见	profound view
深入经藏	go deep into the sutra pitaka
添加剂	additives
清众	monastics without posts
清净	quiet
清规	rules
清华大学	Tsinghua University
清华大学人文学院历史系暨思想文化研究所	Department of History and Institute of Humanities in Tsinghua University
清华大学政治经济学研究中心	Political Economy Research Center of Tsinghua University (TSU)
清华科技园	Tus Park ( Tsinghua University Science Park )
清明节	Qingming holiday
清明祭祖报恩法会	Qingming Worshipping Ancestors & Repaying Gratitude Dharma Assembly
清远山里香	Natural Mountain Incense
渊源	origin
渐次	step by step ; gradually; the stages
温经养血	warm the body and nourish the blood
源远流长	extensive and profound history
滤水囊	water filter
滴灌	drip irrigation
灯谜	lantern riddle
灾害救助中心	Calamity Salvation Centre
灾害联合救助联盟	Calamity Salvation Union
烦恼	afflictions； attachments
煮茶听琴	enjoyed tea and traditional music
熏习	learning and practicing
熏修	practice
熬狱沟	Aoyu Gully
爱国爱教	Love for the nation and religion
爱心粥	Free porridge
爱心捐赠仪式	Love Donation Ceremony
牛津大学圣安尼学院	St Anne’s College of University of Oxford
牧师	priest
牧牛图颂	Ten Ox-Herding Pictures
物欲	desire for material
物业中心	Property Center
班会	class meeting
班委	class committee
班务会	class routine meeting
班导法师	monastic class instructors
班长班	the monitors' class
理念	ideas
理事会	council
理事长	director
瑜伽派	Yogacara
瑜伽师地论	Treatise on the Stages of Yogic Practic
瑜伽行派	Yogacara school
瑞相	auspicious sign
甘露	nectar; Sweet Dew；learning Buddhism
甘之如饴	enjoy sth bitter as if it were malt sugar/willingly and gladly
生平	biographies
生死	birth and death
生命历程	life course
生命回顾	life review
生命导航	Life Navigation
生命教育专项基金	Special Fund to Life Education
生命时报	Life Times
用功	practice;study
用斋	have meals
用功办道	practice and promote the Dharma ;focus on Dharma study and practice
用功方向	the direction of cultivation
用心（名词）	diligence
田园生活	pastoral life
男众	males
畅所欲言	speak freely
留守儿童	left-behind children
疏文	text for commentaries
病障	illness
皈依	Refuge
皈依三宝	going for refuge to the Three Jewels
皈依仪式	refuge ceremony
盂兰盆供	the Ullambana offering
盂兰盆孝亲报恩法会	Ullambana Dharma Assembly aiming at expressing gratitude to parents and ancestors
盂兰盆法会	the Ullambana Dharma Assembly
益人社	Yiren Society
监院	Monastic Manager
监斋菩萨紧那罗王	the King of Kinnara, the dining supervisor Bodhisattva
相应	to correspond with
相得益彰	complement each other
相映成趣	contrast finely with each other
真善美	Truth, Goodness and Beauty
瞻礼	worship
瞻礼祈福大会	Grand Blessing and Worship Ceremony
知见	view
知客/知客师	Guest Prefect
石磨盘	stone mill
研学	research and study
研修处	Instructor Affairs Division
研究员	researcher
破土而出	sprout
破迷开悟	move away from confusion and toward enlightenment
示寂	Parinirvana
示现	samdarsana
示寂回向莲品高增法会	Dedicating Merits to A High Grade Reincarnation in the Pure Land
礼仪	etiquette
礼佛	pay respect to the Buddha;paying respect for Buddha
礼忏	repentance
礼拜	worship; religious service; week
礼请	invite
社会和谐	social harmony
社会大众	the public
社会科学	social science
社会道德	Social Morality
社区服务中心	Community Service Center
社科院梵文研习班	the Sanskrit seminar of the China Academy of Social Sciences
祈愿	pray
祈求	pray
祈祷	pray
祈福	pray for bliss
祈雨	pray for rain
祈愿文	prayer
祖先	ancestors
祖制	regulations
祖师	patriarch
祖师塔	patriarch’s stupa
祝祷	pray for
祥和	peaceful and harmonious
祭祖	worshipping ancestors
祭灶仪式	Kitchen God Worshipping
禅修	meditation
禅凳	Buddhist stools
禅坐	meditation
禅堂	Chan Room;Meditation Room;Zen Room
禅定	Buddhist meditation
禅师	Chan Master
禅意	the meaning of Zen;the meaning of Chan
禅法	Zen Buddhism
禅观	meditation
禅学会	Chan Study Union
福慧	bliss and wisdom
福报	great merits; good fortune;karmic reward
福田	help the public cultivate virtue
福祉	the Wellbeing;welfare;blessing
福州象峰崇福寺	Chongfu Monastery of Fuzhou's Xiang Mount
福建佛学院	Fujian Buddhist College
福建莆田广化寺	Putian Guanghua Monastery
福慧双修	to cultivate bliss and wisdom together
福慧增长	increase their bliss and wisdom
福田心耕	Cultivating Virtue by Heart
离妄得真	move gradually away from confusion and toward enlightenment and from delusion to truth; emerge from illusions and start to entire truth
离苦得乐	ridding people from suffering while helping them to be happy; avoid suffering and be happy
秉承	Adhere to;observe
秘书处	secretariat
秘书长	Secretary-General
积聚资粮	Merits Accumulation
究竟圆满	complete and perfect; true perfection
突击队	The storm troop
端午节	Dragon Boat Festival
端午爱国弘慈精进共修法会	Dharma Practice Assembly of Patriotism and Benevolence during the Dragon Boat Festival
第二佛陀	the second Buddha
等流	habit
答疑解惑	answer questions and resolve puzzles
答谢会	thanksgiving party
策励	encourage
策发	inspire;generate;develop
策修动员会	Mobilization Meeting
筹备会	preparatory meeting
粽子	rice dumplings
精舍	Vihara;sublime abode
精进	diligently; to strive; enhancement; virya
精进力	make great progress in; be more diligent in
精进共修	intense Dharma practice; intensive group practice
系主任	Dean
素斋	vegetarian food
素食	vegetarian food
红十字会	Red Cross; Red Cross Society
红牌位	red memorial tablets
红莲心栈	Honglian Charity Stands
纪录片	documentary
纳受	accept
纽约大学	New York University
纽约时报	The New York Times
线装图书	the thread-bound books
组团	group-forming
组织伦理	organizational means of ethics
组织架构	organizational structure
经书	Buddhist classics; classics
经典	classics and scriptures
经咒	sutras and mantra
经幢	Sutra Pillar; building with Buddhism lection and joss
经藏	Scripture Texts; sutra pitaka
经论	sutras and scriptures; scripture and commentary;sutras and treatises
经中之王	the King of All Sutras
经声佛号	sutra chanting and Buddha names reciting
结界	define certain limitations on the accommodations
结缘	be offered to people for free; become attached to; form ties of
结行	concluding meeting;closing ceremony;summary
结集	a collection of; Buddhist Council
结夏安居	Summer Retreat
绕塔	walk respectfully around the Stupa
绘本	art books ;Picture Book Fair
统稿	the overall editing
统战部	the United Front Work Department
统理大众	guide and manage the group
续佛慧命	carrying on the Buddha’swisdom life
维那	Cantor
维护世界和平法会	Dharma Assembly for the Maintenance of World Peace
缅怀	in commemoration of
缅甸国际上座部佛教大学	International Therevada Buddhist Missionary University of Myanmar
缅甸联邦共和国	the Republic of the Union of Myanmar
编目	Catalogue
编纂	compilation
缘念	chanting the verses
缘起	causation
美德	merit
美中教育服务机构	the Educational Services Exchange with China
美中经济贸易促进会	the US-China Economic & Trade Promotion Association
美国佛教协会	the Buddhist Association of the United States
美国佛教大藏经基金会	the Buddhist Tripitaka Foundation
美国友邦保险公司	American International Assurance Co, Ltd.
美国国际佛教联合会	the International Buddhist Association of the United States
美国基金会中心	the U.S. Foundation Center
美国大华盛顿地区市政管委会	Metropolitan Washington Council of Governments
美国宗教研究所	the Institute for the Study of American Religion
美国特许金融分析师协会（CFA)	Chartered Financial Analysts Institute
美国驻华大使馆	The U.S. Embassy in China
群策群力	pool the wisdom and efforts of everyone
羯磨	karma; karma ceremony
翻译中心	Translation Center
翻译产业论坛	Translation Industry Forum
老年组	the aged group
老年关怀组	the Caring for the Aged Group
老弱病残孕	elderly and disabled; old, weak,sick and disabled
老菩萨	elder laypeople;elderly laypeople
耶鲁大学	Yale University
联合国全球契约组织	the United Nations Global Compact
联席会	joint meeting
联络人	contact
聘任仪式	appointment ceremony
胜因	"great opportunity;
seeds"
胜缘	excellent karmic connections
胡思乱想	go off into wild flights of fancy
腊月	the 12th lunar month; the 12th moon
腊八粥	Laba Porridge; Laba congee
腊八节	Laba Festival
自律	Self-discipline
自恣	Pravarana
自利利他	to benefit themselves and others
自力更生	Self-reliance
自恣法	Pravarana
自我批评	self-criticism
自给自足	self sufficiency
自编自演	performed self-edited programs
至诚恭敬	sincere heart and deferential attitude
致辞	delivered a speech;give a speech
舍利	Sarira
舍利塔	Sarira Stupa
舍功德衣	forsaking Robes of Merits
艺文涵泳	Art-Literature Permeation
艾草	Asiatic wormwood
芦山栈	Lushan Charity Stand
芳草长亭	Fangcao Pavilion
英国广播公司	the British Broadcasting Corporation
草木神	ghosts and deities that inhabit the woods and grasses
荞麦茶	buckwheat tea
荣辱祸福	glories,shames,misfortunes and fortunes
药师经	the Sutra of the Medicine Buddha
药饵针石	medicine
荷担如来家业	undertake Buddha’s responsibilities
莅临	attend
莘莘学子	students
菜虫专区	special cabbageworm area
菩提	Bodhi
菩萨	Bodhisattvas
菩提心	Bodhi Mind
菩提伽耶	Bodhigaya
菩提教育基金会	Bodhi Education Foundation
菩提道次第广论	The Great Treatise on the Stages of the Path to Enlightenment
菩提道次第广论四家合注	Four Interwoven Annotations of The Great Treatise on the Stages of the Path to Enlightenment
菩提道次第略论	A Summary of the Stages of Path to Enlightenment
菩萨戒	Bodhisattva Precepts
菩萨戒本	Bodhisattva-pratimoksa
落下帷幕	ended
董事长	president
董事局主席	chairman
蒙山施食	Dharma services liberating ghosts and deceased spirits
蒙山超度	Dharma services that liberate ghosts and deceased spirits
藏书	collection of books
藏传佛教	Tibetan Buddhism
虔敬	devout
虔诚	piously
融通	integration
血肉相联	have the same bloodline
行堂	food service
行持	Practice
行谊	words and deeds
行为仪止	behaviors and conducts
行云流水	drifting clouds and flowing water
行住坐卧	walking, standing, sitting and lying down
衣物分拣	clothes  sorting
装帧设计	the binding and designing
西切斯特大学	West Chester University
西方三圣	the three Saints of the Pure Land
西来寺	Hsi Lai Temple
西来大学	University of the West
西游记	Journey to the West
西跨院	West Yard
西跨院老大殿遗址	the original hall site in the West Yard
要义	essential ideas
见行堂语	Jianxing Hall Quotation
见行堂/见行堂佛堂	Jianxing Hall
见面会	meet-and-greet
观待	observing dependent arising
观想	meditation;visulization
观照	keeping minds illuminated
观世音菩萨	BodhisattvaAvalokitesvara
观功念恩	Observing Merits and Remembering Kindness
视听资源	audio-visual resources
觉性	awareness；nature of awareness; Buddha nature;Caitanya
觉知	congnition
觉悟之道	The Path to Enlightenment
解读	give explanations for ;give interpretation of
解放军总政治部	General Political Department of People's Liberation Army
解行相应	to correspond understanding with behavior
言教	verbal teachings
讲授	give a lecture;teach
讲法	lecture of Bhddha Dhama；lecture
讲师团	the lecturer Mission; the Instructors Group
讲师班	lecturer's class;instructor's class
讲师课	course for lecturers ; course for instructors
证悟	enlightenment
译师	translation masters
译经	translation of Buddhist scriptures
译员交流会	Seminar for Translators and Interpreters
诞生日	birthday
诵戒	chanting Precepts
诵经	sutra chanting
请戒	invite guidance to Receive Precepts
请益	ask
诸佛本怀	the innate of all Bodhisattvas
诸佛菩萨	all Buddhas and Bodhisattvas
调心	moderate mind
调息	moderate breath
调柔	moderate
调研	research
调身	moderate body
财政部	the Ministry of Finance
贤二律师传	The Stories of Ven. Xian Er
贤德老人	virtuous elders
质朴	simple and plain
贪着	attachment to
资粮	merit;provision
资格证书	Qualification Certificates
资源共享	resources sharing
赞偈	the hymn of Saha Realm
赞叹	appreciation
赞颂	praise and chant
赞佛偈	Hymn of Praising Buddha
赞叹不已	give high praise
赞诵唱念	praise and chant
起心动念	rising and falling of our thoughts
超度	Dharma services to liberate ghosts
超荐	pray for survivors and those who died
超越自我	go beyond oneself
跏趺坐	Vajua Posture;corss legs on lotus position
践行	fulfil;practice
身心	body and mind
身病	body disease
身、口、意三业	three karmas from body, speech and mind
身、语行为	body and language behaviors
身体力行	practice what they preach
身心安稳	dwell body and mind
轨范	criterion;standard
轮值	on duty
辗转增上	progress interactively
辞亲割爱	Separation from relatives and loved ones
辞旧岁	Cleanse out the old year
过堂	monastic meals
过患	the problems and tribulations of life
迎归团	the welcome-back group
迎春祈福华严法会	Avatamsaka Dharma Assembly for Spring Greeting and Bliss Praying
进程	process
迦絺那衣	Sra-brkyan
送座	authorize the seat
送温暖活动	Sending Warmth
通启二师	Announcing and Inviting Two Masters
造福	bringing bliss to;benefit
道义	moral
道场	monastery
道心	resolve for the Bodhi Path
道念	aspirations and vows to follow the Bodhi Path;resolve for the Bodhi Path
道总	the general presentation of the Bodhi path
道教	Taoism
道风	Buddhist ethics
道德峰	Morality Peak
道德重建	moral reconstruction
道教全真派祖庭	ancestral temple of Chuan Chen School of Chinese Taoism
道教宫观	Taoist Temple
道次第	Stages of Path; Gradual Path
道次纲要	Outline of the Stages of the Buddha’s Path
道诜寺	Dosunsa Temple
遗志	unfinished work
邪教	Cults
邻里	neighborhood
部组	departments
酥油灯	butter lamps
醍醐	Enlightened
释迦牟尼佛	SakyamuniBuddha
释迦牟尼佛出家日	SakyamuniBuddha’s Renunciation Day
释迦牟尼佛出家日法会	Dharma Assembly commemorating Shakyamuni Buddha's Renunciation
释迦牟尼佛圣诞	the auspicious birthday of  Shakyamuni Buddha
释迦牟尼佛成道日	the day Shakyamuni Buddha attained his Enlightenment
重阳	Double Ninth Festival
重阳明星	Stars of the Double Ninth Festival
重阳暖心孝亲敬老法会	Double Ninth Festival Warm Heart Dharma Assembly for promoting filial piety and respecting elders
重阳暖心法会	Double Ninth Festival Warm Heart Dharma Assembly
金佛山佛教文化研讨会	Jinfoshan Buddhist Culture Seminar
金光明最胜王经	Golden Light Sutra Recitation
金刚经	Diamond Sutra
金龙桥	Golden Dragon Bridge
钟鼓复鸣	the restoration of the bell and drum
钟鼓齐鸣	the mixed sound of ringing bells and beating drum
钵具	alms bowl
钵碗	alms bowl
银杏树	Ginkgo tree
银装素裹	silver-coated
长养	nurture
长老	Great Elder; Ven. Master
长久住世	continued existence;long life;long live
长寿面	Long Life Noodles
长效机制	long-term mechanism
长江商学院	Cheung Kong Graduate School of Business
长远发心	continuously aspired
门道房	gateway room
闭关	retreat
问道龙泉	talk on questioning the Longquan Path
闻思修	hearing, thinking, and meditating
防护	security;protect;secure
阴阳历	solar and lunar calendars
阿含宗	Agon Shu
阿底峡尊者	Ven. Atisha
阿弥陀佛	Amitabha Buddha
阿弥陀经	Amitabha Sutra
陀罗尼	the Dharani
陕西扶风法门寺	Famen Monastery in Fufeng County, Shaanxi Province
除夕	Lunar New Year’s Eve
陪堂	Assistant Instructor
陶铸圣贤	cultivating sages
随众	with the public
随喜	Rejoice
随缘	accord with the conditions
随顺	In accordance with
随机开示	give a Dharma talk
难逢难遇	very difficult to meet
集众	set public; call on people gather together
雕塑组	Sculpture Group
静坐	sit still; sitting meditation
静思书轩	Jing Si Books & Café
非公募基金会	Private Foundation
非政府组织	Non-Governmental Organizations
面人	dough figurine
面貌	face
韩国佛教曹溪宗总务院	the General Affairs Department of JogyeOrder of Korean Buddhism
韩国儒教协会	Korea Confucian Association
韩国宗教和平会议	Korea Conference of Religion for Peace
韩国教会理事会	Korea Confucian Association
音声供养	voice offering
须弥山	Mount Meru
须弥世界	the Meru world
领众	get along as a group
题词	write an inscription
风俗	folklore
风气	environmen;habits;atmosphere
风貌	good qualities;features;public image;style and features
风调雨顺	good weather;fair weather;favorable weather;peaceful life and favorable weather
风雨历程	trials and hardships
风雨无阻	in all kinds of weather
风雨洗礼	Experiencing through wind and rain; weathering through wind and rain
食育	diet education
饮水思源	think of source when drink water
饮食知量	Appropriate Diet
首席代表	chief representative
首日封	first-day cover
首都慈善公益组织联合会	Capital Philanthropy Federation
首都慈善晚会	Capital Charity Evening Party
香包	incense bags
香板	warning stick
香汤功德水	fragrant water
香汤灌沐	bath with fragrant water
香港佛教联合会	Hong Kong Buddhist Association
香港宝莲禅寺	Hong Kong Po Lin Monastery
香港良友图书公司	Hong Companion Books Limited
香灯组	the Incense and Lamp Group
香积广场	Xiangji Square
马鸣菩萨	Bodhisattva Asvaghosa
驻京记者	Beijing-based correspondents
高僧	eminent monk;senior monks
鬼神	spirits; ghosts and gods; supernatural beings
魏老爷塔	Wei Laoye Pagoda
齐头并进	be developed together
龙华寺	Longhua Temple
龙天欢喜	the gods and the dragons were filled with joy
龙天耳目	the ears and eyes of the Dharma-protecting dragons and heavenly beings
龙树菩萨	Bodhisattva Nagarjuna
龙泉之声/龙泉之声传统文化网/龙泉之声网站	the Voice of Longquan
龙泉之声倾听热线	the Voice of Longquan Hotline
龙泉之声电子报	the Voice of Longquan electronic newspaper
龙泉之声网站英文版	the Voice of Longquan English website
龙泉之声艺术团	The Arts Troupe of Voice of Longquan
龙泉夜话	Longquan Evening Talks
龙泉日记	Longquan Diary
龙泉祈愿香	Longquan Prayer Incense
龙泉论坛	Longquan BBS
龙鳞装	The Dragon Scale Binding

